link	 agency
/welcome/agencyarrests/3/Alameda_Police	Alameda Police
/welcome/agencyarrests/253/Alameda_County_Sheriff	Alameda County Sheriff
/welcome/agencyarrests/5/Alhambra_Police	Alhambra Police
/welcome/agencyarrests/254/Alpine_County_Sheriff	Alpine County Sheriff
/welcome/agencyarrests/286/Altadena_CHP	Altadena CHP
/welcome/agencyarrests/328/Altadena_Sheriff_Substation	Altadena Sheriff Substation
/welcome/agencyarrests/595/Alturas_CHP	Alturas CHP
/welcome/agencyarrests/610/Amador_CHP	Amador CHP
/welcome/agencyarrests/255/Amador_County_Sheriff	Amador County Sheriff
/welcome/agencyarrests/249/American_Canyon_Police	American Canyon Police
/welcome/agencyarrests/8/Anaheim_Police	Anaheim Police
/welcome/agencyarrests/414/Antelope_Valley_CHP	Antelope Valley CHP
/welcome/agencyarrests/11/Antioch_Police	Antioch Police
/welcome/agencyarrests/13/Arcadia_Police	Arcadia Police
/welcome/agencyarrests/259/Arrowhead_CHP	Arrowhead CHP
/welcome/agencyarrests/15/Arroyo_Grande_Police	Arroyo Grande Police
/welcome/agencyarrests/18/Atascadero_Police	Atascadero Police
/welcome/agencyarrests/598/Auburn_CHP	Auburn CHP
/welcome/agencyarrests/22/Avalon_Sheriff_Substation	Avalon Sheriff Substation
/welcome/agencyarrests/23/Azusa_Police	Azusa Police
/welcome/agencyarrests/124/Bakersfield_CHP	Bakersfield CHP
/welcome/agencyarrests/24/Bakersfield_Police	Bakersfield Police
/welcome/agencyarrests/485/Baldwin_Park_CHP	Baldwin Park CHP
/welcome/agencyarrests/25/Baldwin_Park_Police	Baldwin Park Police
/welcome/agencyarrests/676/Banning_Police	Banning Police
/welcome/agencyarrests/211/Barstow_CHP	Barstow CHP
/welcome/agencyarrests/758/BART_Police	BART Police
/welcome/agencyarrests/677/Beaumont_Police	Beaumont Police
/welcome/agencyarrests/30/Bell_Police	Bell Police
/welcome/agencyarrests/32/Bell_Gardens_Police	Bell Gardens Police
/welcome/agencyarrests/35/Benicia_Police	Benicia Police
/welcome/agencyarrests/36/Berkeley_-_UC_Police	Berkeley - UC Police
/welcome/agencyarrests/2130/Berkeley_PD_Police	Berkeley PD Police
/welcome/agencyarrests/82/Beverly_Hills_Police	Beverly Hills Police
/welcome/agencyarrests/313/Bishop_CHP	Bishop CHP
/welcome/agencyarrests/296/Blythe_CHP	Blythe CHP
/welcome/agencyarrests/561/Brea_Police	Brea Police
/welcome/agencyarrests/312/Bridgeport_CHP	Bridgeport CHP
/welcome/agencyarrests/309/Buellton_CHP	Buellton CHP
/welcome/agencyarrests/40/Buena_Park_Police	Buena Park Police
/welcome/agencyarrests/41/Burbank_Police	Burbank Police
/welcome/agencyarrests/256/Butte_County_Sheriff	Butte County Sheriff
/welcome/agencyarrests/564/Buttonwillow_CHP	Buttonwillow CHP
/welcome/agencyarrests/2121/CA_Dept._Of_Alcoholic_Beverage_Control	CA Dept. Of Alcoholic Beverage Control 
/welcome/agencyarrests/2067/Cal_State_Chico_Police	Cal State Chico Police
/welcome/agencyarrests/611/Calaveras_County_Sheriff	Calaveras County Sheriff
/welcome/agencyarrests/48/Calistoga_Police	Calistoga Police
/welcome/agencyarrests/49/Campbell_Police	Campbell Police
/welcome/agencyarrests/2039/Campus_Parks_Sheriff_Substation	Campus Parks Sheriff Substation
/welcome/agencyarrests/168/Capistrano_CHP	Capistrano CHP
/welcome/agencyarrests/51/Capitola_Police	Capitola Police
/welcome/agencyarrests/52/Carlsbad_Police	Carlsbad Police
/welcome/agencyarrests/53/Carmel_Police	Carmel Police
/welcome/agencyarrests/55/Carson_Sheriff_Substation	Carson Sheriff Substation
/welcome/agencyarrests/678/Cathedral_City_Police	Cathedral City Police
/welcome/agencyarrests/484/Central_Los_Angeles_CHP	Central Los Angeles CHP
/welcome/agencyarrests/272/Century_Sheriff_Substation	Century Sheriff Substation
/welcome/agencyarrests/367/Cerritos_Sheriff_Substation	Cerritos Sheriff Substation
/welcome/agencyarrests/602/Chico_CHP	Chico CHP
/welcome/agencyarrests/59/Chico_Police	Chico Police
/welcome/agencyarrests/61/Chino_Police	Chino Police
/welcome/agencyarrests/62/Chowchilla_Police	Chowchilla Police
/welcome/agencyarrests/2136/chp_state_capitol_division_CHP	chp state capitol division CHP
/welcome/agencyarrests/63/Chula_Vista_Police	Chula Vista Police
/welcome/agencyarrests/671/Citrus_Heights_Police	Citrus Heights Police
/welcome/agencyarrests/64/Claremont_Police	Claremont Police
/welcome/agencyarrests/107/Clayton_Police	Clayton Police
/welcome/agencyarrests/591/Clear_Lake_CHP	Clear Lake CHP
/welcome/agencyarrests/2112/Cloverdale_Police	Cloverdale Police
/welcome/agencyarrests/67/Clovis_Police	Clovis Police
/welcome/agencyarrests/483/Coalinga_CHP	Coalinga CHP
/welcome/agencyarrests/71/Colma_Police	Colma Police
/welcome/agencyarrests/72/Colton_Police	Colton Police
/welcome/agencyarrests/612/Colusa_County_Sheriff	Colusa County Sheriff
/welcome/agencyarrests/74/Compton_Sheriff_Substation	Compton Sheriff Substation
/welcome/agencyarrests/75/Concord_Police	Concord Police
/welcome/agencyarrests/101/Contra_Costa_CHP	Contra Costa CHP
/welcome/agencyarrests/613/Contra_Costa_County_Sheriff	Contra Costa County Sheriff
/welcome/agencyarrests/78/Corona_Police	Corona Police
/welcome/agencyarrests/79/Coronado_Police	Coronado Police
/welcome/agencyarrests/81/Costa_Mesa_Police	Costa Mesa Police
/welcome/agencyarrests/91/Cotati_Police	Cotati Police
/welcome/agencyarrests/443/Covina_Police	Covina Police
/welcome/agencyarrests/229/Crescent_City_CHP	Crescent City CHP
/welcome/agencyarrests/271/Cresenta_Valley_Sheriff_Substation	Cresenta Valley Sheriff Substation
/welcome/agencyarrests/330/Culver_City_Police	Culver City Police
/welcome/agencyarrests/556/Cypress_Police	Cypress Police
/welcome/agencyarrests/557/Daly_City_Police	Daly City Police
/welcome/agencyarrests/136/Davis_Police	Davis Police
/welcome/agencyarrests/2102/Del_Norte_County_Sheriff	Del Norte County Sheriff
/welcome/agencyarrests/137/Delano_Police	Delano Police
/welcome/agencyarrests/761/Desert_Hot_Springs_Police	Desert Hot Springs Police
/welcome/agencyarrests/334/Dinuba_Police	Dinuba Police
/welcome/agencyarrests/335/Dixon_Police	Dixon Police
/welcome/agencyarrests/126/Downey_Police	Downey Police
/welcome/agencyarrests/122/Dublin_CHP	Dublin CHP
/welcome/agencyarrests/110/Dublin_Police	Dublin Police
/welcome/agencyarrests/487/East_Los_Angeles_CHP	East Los Angeles CHP
/welcome/agencyarrests/445/East_Los_Angeles_Sheriff_Substation	East Los Angeles Sheriff Substation
/welcome/agencyarrests/112/East_Palo_Alto_Police	East Palo Alto Police
/welcome/agencyarrests/299/El_Cajon_CHP	El Cajon CHP
/welcome/agencyarrests/113/El_Cajon_Police	El Cajon Police
/welcome/agencyarrests/290/El_Centro_CHP	El Centro CHP
/welcome/agencyarrests/673/El_Cerrito_Police	El Cerrito Police
/welcome/agencyarrests/615/El_Dorado_County_Sheriff	El Dorado County Sheriff
/welcome/agencyarrests/115/El_Monte_Police	El Monte Police
/welcome/agencyarrests/116/El_Segundo_Police	El Segundo Police
/welcome/agencyarrests/117/Emeryville_Police	Emeryville Police
/welcome/agencyarrests/491/Escondido_Police	Escondido Police
/welcome/agencyarrests/496/Fairfield_Police	Fairfield Police
/welcome/agencyarrests/502/Folsom_Police	Folsom Police
/welcome/agencyarrests/503/Fontana_Police	Fontana Police
/welcome/agencyarrests/565/Fort_Tejon_CHP	Fort Tejon CHP
/welcome/agencyarrests/508/Fountain_Valley_Police	Fountain Valley Police
/welcome/agencyarrests/2030/Fremont_Police	Fremont Police
/welcome/agencyarrests/566/Fresno_CHP	Fresno CHP
/welcome/agencyarrests/512/Fresno_Police	Fresno Police
/welcome/agencyarrests/616/Fresno_County_Sheriff	Fresno County Sheriff
/welcome/agencyarrests/513/Fullerton_Police	Fullerton Police
/welcome/agencyarrests/514/Galt_Police	Galt Police
/welcome/agencyarrests/231/Garberville_CHP	Garberville CHP
/welcome/agencyarrests/516/Garden_Grove_Police	Garden Grove Police
/welcome/agencyarrests/515/Gardena_Police	Gardena Police
/welcome/agencyarrests/517/Gilroy_Police	Gilroy Police
/welcome/agencyarrests/560/Glendale_Police	Glendale Police
/welcome/agencyarrests/518/Glendora_Police	Glendora Police
/welcome/agencyarrests/617/Glenn_County_Sheriff	Glenn County Sheriff
/welcome/agencyarrests/662/Gold_Run_CHP	Gold Run CHP
/welcome/agencyarrests/600/Grass_Valley_CHP	Grass Valley CHP
/welcome/agencyarrests/522/Grass_Valley_Police	Grass Valley Police
/welcome/agencyarrests/337/Gridley_Police	Gridley Police
/welcome/agencyarrests/338/Grover_Beach_Police	Grover Beach Police
/welcome/agencyarrests/567/Hanford_CHP	Hanford CHP
/welcome/agencyarrests/141/Hawthorne_Police	Hawthorne Police
/welcome/agencyarrests/106/Hayward_CHP	Hayward CHP
/welcome/agencyarrests/142/Hayward_Police	Hayward Police
/welcome/agencyarrests/143/Healdsburg_Police	Healdsburg Police
/welcome/agencyarrests/144/Hemet_Police	Hemet Police
/welcome/agencyarrests/155/Hermosa_Beach_Police	Hermosa Beach Police
/welcome/agencyarrests/170/Hollister-Gilroy_CHP	Hollister-Gilroy CHP
/welcome/agencyarrests/230/Humboldt_CHP	Humboldt CHP
/welcome/agencyarrests/618/Humboldt_County_Sheriff	Humboldt County Sheriff
/welcome/agencyarrests/162/Huntington_Beach_Police	Huntington Beach Police
/welcome/agencyarrests/341/Huntington_Park_Police	Huntington Park Police
/welcome/agencyarrests/2095/Imperial_County_Sheriff	Imperial County Sheriff
/welcome/agencyarrests/291/Indio_CHP	Indio CHP
/welcome/agencyarrests/679/Indio_Police	Indio Police
/welcome/agencyarrests/128/Industry_Sheriff_Substation	Industry Sheriff Substation
/welcome/agencyarrests/129/Inglewood_Police	Inglewood Police
/welcome/agencyarrests/239/Inyo_County_Sheriff	Inyo County Sheriff
/welcome/agencyarrests/131/Irvine_Police	Irvine Police
/welcome/agencyarrests/132/Irwindale_Police	Irwindale Police
/welcome/agencyarrests/620/Kern_County_Sheriff	Kern County Sheriff
/welcome/agencyarrests/305/King_City_CHP	King City CHP
/welcome/agencyarrests/621/Kings_County_Sheriff	Kings County Sheriff
/welcome/agencyarrests/398/Kingsburg_Police	Kingsburg Police
/welcome/agencyarrests/402/La_Habra_Police	La Habra Police
/welcome/agencyarrests/408/La_Mesa_Police	La Mesa Police
/welcome/agencyarrests/149/La_Verne_Police	La Verne Police
/welcome/agencyarrests/622/Lake_County_Sheriff	Lake County Sheriff
/welcome/agencyarrests/58/Lakewood_Sheriff_Substation	Lakewood Sheriff Substation
/welcome/agencyarrests/147/Lancaster_Sheriff_Substation	Lancaster Sheriff Substation
/welcome/agencyarrests/623/Lassen_County_Sheriff	Lassen County Sheriff
/welcome/agencyarrests/150/Lennox_Sheriff_Substation	Lennox Sheriff Substation
/welcome/agencyarrests/198/Livermore_Police	Livermore Police
/welcome/agencyarrests/202/Lomita_Sheriff_Substation	Lomita Sheriff Substation
/welcome/agencyarrests/203/Lompoc_Police	Lompoc Police
/welcome/agencyarrests/204/Long_Beach_Police	Long Beach Police
/welcome/agencyarrests/207/Los_Altos_Police	Los Altos Police
/welcome/agencyarrests/460/Los_Angeles_Police	Los Angeles Police
/welcome/agencyarrests/467/Los_Angeles_County_Sheriff	Los Angeles County Sheriff
/welcome/agencyarrests/314/Los_Banos_CHP	Los Banos CHP
/welcome/agencyarrests/462/Los_Gatos_-_Monte_Sereno_Police	Los Gatos - Monte Sereno Police
/welcome/agencyarrests/568/Madera_CHP	Madera CHP
/welcome/agencyarrests/466/Madera_Police	Madera Police
/welcome/agencyarrests/468/Madera_County_Sheriff	Madera County Sheriff
/welcome/agencyarrests/464/Malibu_-_Lost_Hills_Sheriff_Substation	Malibu - Lost Hills Sheriff Substation
/welcome/agencyarrests/346/Manhattan_Beach_Police	Manhattan Beach Police
/welcome/agencyarrests/108/Marin_CHP	Marin CHP
/welcome/agencyarrests/469/Marin_County_Sheriff	Marin County Sheriff
/welcome/agencyarrests/324/Marina_Police	Marina Police
/welcome/agencyarrests/270/Marina_Del_Rey_Sheriff_Substation	Marina Del Rey Sheriff Substation
/welcome/agencyarrests/569/Mariposa_CHP	Mariposa CHP
/welcome/agencyarrests/470/Mariposa_County_Sheriff	Mariposa County Sheriff
/welcome/agencyarrests/325/Martinez_Police	Martinez Police
/welcome/agencyarrests/471/Mendocino_County_Sheriff	Mendocino County Sheriff
/welcome/agencyarrests/357/Menlo_Park_Police	Menlo Park Police
/welcome/agencyarrests/570/Merced_CHP	Merced CHP
/welcome/agencyarrests/358/Merced_Police	Merced Police
/welcome/agencyarrests/216/Merced_County_Sheriff	Merced County Sheriff
/welcome/agencyarrests/361/Milpitas_Police	Milpitas Police
/welcome/agencyarrests/315/Modesto_CHP	Modesto CHP
/welcome/agencyarrests/362/Modesto_Police	Modesto Police
/welcome/agencyarrests/217/Modoc_County_Sheriff	Modoc County Sheriff
/welcome/agencyarrests/209/Mojave_CHP	Mojave CHP
/welcome/agencyarrests/2041/Mono_County_Sheriff	Mono County Sheriff
/welcome/agencyarrests/364/Monrovia_Police	Monrovia Police
/welcome/agencyarrests/366/Montclair_Police	Montclair Police
/welcome/agencyarrests/431/Montebello_Police	Montebello Police
/welcome/agencyarrests/488/Monterey_CHP	Monterey CHP
/welcome/agencyarrests/665/Monterey_Police	Monterey Police
/welcome/agencyarrests/237/Monterey_County_Sheriff	Monterey County Sheriff
/welcome/agencyarrests/432/Monterey_Park_Police	Monterey Park Police
/welcome/agencyarrests/656/Moorpark_CHP	Moorpark CHP
/welcome/agencyarrests/434/Morgan_Hill_Police	Morgan Hill Police
/welcome/agencyarrests/260/Morongo_Basin_CHP	Morongo Basin CHP
/welcome/agencyarrests/435/Morro_Bay_Police	Morro Bay Police
/welcome/agencyarrests/589/Mount_Shasta_CHP	Mount Shasta CHP
/welcome/agencyarrests/436/Mountain_View_Police	Mountain View Police
/welcome/agencyarrests/681/Murrieta_Police	Murrieta Police
/welcome/agencyarrests/102/Napa_CHP	Napa CHP
/welcome/agencyarrests/2118/Napa_Police	Napa Police
/welcome/agencyarrests/479/Napa_County_Sheriff	Napa County Sheriff
/welcome/agencyarrests/439/National_City_Police	National City Police
/welcome/agencyarrests/210/Needles_CHP	Needles CHP
/welcome/agencyarrests/441/Nevada_City_Police	Nevada City Police
/welcome/agencyarrests/480/Nevada_County_Sheriff	Nevada County Sheriff
/welcome/agencyarrests/442/Newark_Police	Newark Police
/welcome/agencyarrests/459/Newhall_CHP	Newhall CHP
/welcome/agencyarrests/274/Newport_Beach_Police	Newport Beach Police
/welcome/agencyarrests/597/North_Sacramento_CHP	North Sacramento CHP
/welcome/agencyarrests/389/Norwalk_Sheriff_Substation	Norwalk Sheriff Substation
/welcome/agencyarrests/276/Novato_Police	Novato Police
/welcome/agencyarrests/663/Oakhurst_CHP	Oakhurst CHP
/welcome/agencyarrests/121/Oakland_CHP	Oakland CHP
/welcome/agencyarrests/278/Oakland_Police	Oakland Police
/welcome/agencyarrests/293/Oceanside_CHP	Oceanside CHP
/welcome/agencyarrests/279/Oceanside_Police	Oceanside Police
/welcome/agencyarrests/379/Ontario_Police	Ontario Police
/welcome/agencyarrests/446/Orange_Police	Orange Police
/welcome/agencyarrests/558/Orange_County_Sheriff	Orange County Sheriff
/welcome/agencyarrests/601/Oroville_CHP	Oroville CHP
/welcome/agencyarrests/451/Oxnard_Police	Oxnard Police
/welcome/agencyarrests/529/Palm_Springs_Police	Palm Springs Police
/welcome/agencyarrests/527/Palmdale_Sheriff_Substation	Palmdale Sheriff Substation
/welcome/agencyarrests/281/Palo_Alto_Police	Palo Alto Police
/welcome/agencyarrests/282/Palos_Verdes_Estates_Police	Palos Verdes Estates Police
/welcome/agencyarrests/284/Parlier_Police	Parlier Police
/welcome/agencyarrests/153/Pasadena_Police	Pasadena Police
/welcome/agencyarrests/409/Paso_Robles_Police	Paso Robles Police
/welcome/agencyarrests/412/Petaluma_Police	Petaluma Police
/welcome/agencyarrests/413/Pico_Rivera_Sheriff_Substation	Pico Rivera Sheriff Substation
/welcome/agencyarrests/453/Piedmont_Police	Piedmont Police
/welcome/agencyarrests/2091/Pinole_Police	Pinole Police
/welcome/agencyarrests/457/Pismo_Beach_Police	Pismo Beach Police
/welcome/agencyarrests/458/Pittsburg_Police	Pittsburg Police
/welcome/agencyarrests/380/Placentia_Police	Placentia Police
/welcome/agencyarrests/151/Placer_County_Sheriff	Placer County Sheriff
/welcome/agencyarrests/603/Placerville_CHP	Placerville CHP
/welcome/agencyarrests/382/Pleasant_Hill_Police	Pleasant Hill Police
/welcome/agencyarrests/383/Pleasanton_Police	Pleasanton Police
/welcome/agencyarrests/2063/Plumas_County_Sheriff	Plumas County Sheriff
/welcome/agencyarrests/386/Pomona_Police	Pomona Police
/welcome/agencyarrests/482/Porterville_CHP	Porterville CHP
/welcome/agencyarrests/387/Porterville_Police	Porterville Police
/welcome/agencyarrests/594/Quincy_CHP	Quincy CHP
/welcome/agencyarrests/311/Rancho_Cucamonga_CHP	Rancho Cucamonga CHP
/welcome/agencyarrests/232/Red_Bluff_CHP	Red Bluff CHP
/welcome/agencyarrests/233/Redding_CHP	Redding CHP
/welcome/agencyarrests/579/Redding_Police	Redding Police
/welcome/agencyarrests/580/Redlands_Police	Redlands Police
/welcome/agencyarrests/581/Redondo_Beach_Police	Redondo Beach Police
/welcome/agencyarrests/103/Redwood_City_CHP	Redwood City CHP
/welcome/agencyarrests/582/Redwood_City_Police	Redwood City Police
/welcome/agencyarrests/583/Reedley_Police	Reedley Police
/welcome/agencyarrests/584/Rialto_Police	Rialto Police
/welcome/agencyarrests/585/Richmond_Police	Richmond Police
/welcome/agencyarrests/212/Riverside_CHP	Riverside CHP
/welcome/agencyarrests/317/Riverside_Police	Riverside Police
/welcome/agencyarrests/26/Riverside_SD_-_Banning_Smith_Correctional_Facility_Sheriff	Riverside SD - Banning Smith Correctional Facility Sheriff
/welcome/agencyarrests/87/Riverside_County_-_Blythe_Jail_-_Sheriff	Riverside County - Blythe Jail - Sheriff
/welcome/agencyarrests/327/Riverside_SD_-_John_Benoit_Detention_Center_Sheriff	Riverside SD - John Benoit Detention Center Sheriff
/welcome/agencyarrests/2035/Riverside_County_-_Robert_Presley_DC_-_Sheriff	Riverside County - Robert Presley DC - Sheriff
/welcome/agencyarrests/571/Riverside_County_-_Southwest_DC_-_Sheriff	Riverside County - Southwest DC - Sheriff
/welcome/agencyarrests/172/Rohnert_Park_Police	Rohnert Park Police
/welcome/agencyarrests/176/Roseville_Police	Roseville Police
/welcome/agencyarrests/550/Sacramento_County_Sheriff	Sacramento County Sheriff
/welcome/agencyarrests/605/San_Andreas_CHP	San Andreas CHP
/welcome/agencyarrests/417/San_Benito_County_Sheriff	San Benito County Sheriff
/welcome/agencyarrests/215/San_Bernardino_CHP	San Bernardino CHP
/welcome/agencyarrests/418/San_Bernardino_County_Sheriff	San Bernardino County Sheriff
/welcome/agencyarrests/292/San_Diego_CHP	San Diego CHP
/welcome/agencyarrests/302/San_Diego_Police	San Diego Police
/welcome/agencyarrests/419/San_Diego_County_Sheriff	San Diego County Sheriff
/welcome/agencyarrests/303/San_Dimas_Sheriff_Substation	San Dimas Sheriff Substation
/welcome/agencyarrests/104/San_Francisco_CHP	San Francisco CHP
/welcome/agencyarrests/318/San_Francisco_Police	San Francisco Police
/welcome/agencyarrests/2056/San_Francisco_County_Sheriff	San Francisco County Sheriff
/welcome/agencyarrests/319/San_Gabriel_Police	San Gabriel Police
/welcome/agencyarrests/295/San_Gorgonio_Pass_CHP	San Gorgonio Pass CHP
/welcome/agencyarrests/257/San_Joaquin_County_Sheriff	San Joaquin County Sheriff
/welcome/agencyarrests/105/San_Jose_CHP	San Jose CHP
/welcome/agencyarrests/531/San_Jose_Police	San Jose Police
/welcome/agencyarrests/208/San_Leandro_Police	San Leandro Police
/welcome/agencyarrests/307/San_Luis_Obispo_CHP	San Luis Obispo CHP
/welcome/agencyarrests/214/San_Luis_Obispo_Police	San Luis Obispo Police
/welcome/agencyarrests/258/San_Luis_Obispo_County_Sheriff	San Luis Obispo County Sheriff
/welcome/agencyarrests/422/San_Marino_Police	San Marino Police
/welcome/agencyarrests/423/San_Mateo_Police	San Mateo Police
/welcome/agencyarrests/472/San_Mateo_County_Sheriff	San Mateo County Sheriff
/welcome/agencyarrests/424/San_Pablo_Police	San Pablo Police
/welcome/agencyarrests/425/San_Rafael_Police	San Rafael Police
/welcome/agencyarrests/426/San_Ramon_Police	San Ramon Police
/welcome/agencyarrests/320/Sanger_Police	Sanger Police
/welcome/agencyarrests/298/Santa_Ana_CHP	Santa Ana CHP
/welcome/agencyarrests/427/Santa_Ana_Police	Santa Ana Police
/welcome/agencyarrests/310/Santa_Barbara_CHP	Santa Barbara CHP
/welcome/agencyarrests/428/Santa_Barbara_Police	Santa Barbara Police
/welcome/agencyarrests/473/Santa_Barbara_County_Sheriff	Santa Barbara County Sheriff
/welcome/agencyarrests/265/Santa_Clara_Police	Santa Clara Police
/welcome/agencyarrests/474/Santa_Clara_County_Sheriff	Santa Clara County Sheriff
/welcome/agencyarrests/429/Santa_Clarita_Valley_Sheriff_Substation	 Santa Clarita Valley Sheriff Substation
/welcome/agencyarrests/169/Santa_Cruz_CHP	Santa Cruz CHP
/welcome/agencyarrests/388/Santa_Cruz_Police	Santa Cruz Police
/welcome/agencyarrests/475/Santa_Cruz_County_Sheriff	Santa Cruz County Sheriff
/welcome/agencyarrests/415/Santa_Fe_Springs_CHP	Santa Fe Springs CHP
/welcome/agencyarrests/2052/Santa_Fe_Springs_Police	Santa Fe Springs Police
/welcome/agencyarrests/308/Santa_Maria_CHP	Santa Maria CHP
/welcome/agencyarrests/391/Santa_Monica_Police	Santa Monica Police
/welcome/agencyarrests/392/Santa_Paula_Police	Santa Paula Police
/welcome/agencyarrests/118/Santa_Rosa_CHP	Santa Rosa CHP
/welcome/agencyarrests/393/Santa_Rosa_Police	Santa Rosa Police
/welcome/agencyarrests/534/Seaside_Police	Seaside Police
/welcome/agencyarrests/535/Sebastopol_Police	Sebastopol Police
/welcome/agencyarrests/536/Selma_Police	Selma Police
/welcome/agencyarrests/537/Shafter_Police	Shafter Police
/welcome/agencyarrests/476/Shasta_County_Sheriff	Shasta County Sheriff
/welcome/agencyarrests/541/Simi_Valley_Police	Simi Valley Police
/welcome/agencyarrests/2107/Siskiyou_County_Sheriff	Siskiyou County Sheriff
/welcome/agencyarrests/119/Solano_CHP	Solano CHP
/welcome/agencyarrests/619/Solano_County_Sheriff	Solano County Sheriff
/welcome/agencyarrests/218/Sonoma_County_Sheriff	Sonoma County Sheriff
/welcome/agencyarrests/563/Sonora_CHP	Sonora CHP
/welcome/agencyarrests/547/South_Gate_Police	South Gate Police
/welcome/agencyarrests/604/South_Lake_Tahoe_CHP	South Lake Tahoe CHP
/welcome/agencyarrests/486/South_Los_Angeles_CHP	South Los Angeles CHP
/welcome/agencyarrests/660/South_Sacramento_CHP	South Sacramento CHP
/welcome/agencyarrests/186/South_San_Francisco_Police	South San Francisco Police
/welcome/agencyarrests/2115/St_Helena_Police	St Helena Police
/welcome/agencyarrests/219/Stanislaus_County_Sheriff	Stanislaus County Sheriff
/welcome/agencyarrests/606/Stockton_CHP	Stockton CHP
/welcome/agencyarrests/189/Sunnyvale_Police	Sunnyvale Police
/welcome/agencyarrests/234/Susanville_CHP	Susanville CHP
/welcome/agencyarrests/220/Sutter_County_Sheriff	Sutter County Sheriff
/welcome/agencyarrests/221/Tehama_County_Sheriff	Tehama County Sheriff
/welcome/agencyarrests/167/Temecula_CHP	Temecula CHP
/welcome/agencyarrests/551/Temple_Sheriff_Substation	Temple SheriffSubstation
/welcome/agencyarrests/306/Templeton_CHP	Templeton CHP
/welcome/agencyarrests/163/Torrance_Police	Torrance Police
/welcome/agencyarrests/607/Tracy_CHP	Tracy CHP
/welcome/agencyarrests/222/Trinity_County_Sheriff	Trinity County Sheriff
/welcome/agencyarrests/596/Trinity_River_CHP	Trinity River CHP
/welcome/agencyarrests/599/Truckee_CHP	Truckee CHP
/welcome/agencyarrests/120/Truckee_Police	Truckee Police
/welcome/agencyarrests/166/Tulare_Police	Tulare Police
/welcome/agencyarrests/223/Tulare_County_Sheriff	Tulare County Sheriff
/welcome/agencyarrests/224/Tuolumne_County_Sheriff	Tuolumne County Sheriff
/welcome/agencyarrests/93/Tustin_Police	Tustin Police
/welcome/agencyarrests/763/UC_Irvine_Police	UC Irvine Police
/welcome/agencyarrests/2025/UC_San_Diego_Police	UC San Diego Police
/welcome/agencyarrests/2124/UCLA_Police	UCLA Police
/welcome/agencyarrests/590/Ukiah_CHP	Ukiah CHP
/welcome/agencyarrests/98/Vacaville_Police	Vacaville Police
/welcome/agencyarrests/99/Vallejo_Police	Vallejo Police
/welcome/agencyarrests/228/Ventura_CHP	Ventura CHP
/welcome/agencyarrests/2031/Ventura_Police	Ventura Police
/welcome/agencyarrests/225/Ventura_County_Sheriff	Ventura County Sheriff
/welcome/agencyarrests/100/Vernon_Police	Vernon Police
/welcome/agencyarrests/213/Victorville_CHP	Victorville CHP
/welcome/agencyarrests/481/Visalia_CHP	Visalia CHP
/welcome/agencyarrests/370/Visalia_Police	Visalia Police
/welcome/agencyarrests/373/Walnut_-_Diamond_Bar_Sheriff_Substation	Walnut - Diamond Bar SheriffSubstation
/welcome/agencyarrests/374/Walnut_Creek_Police	Walnut Creek Police
/welcome/agencyarrests/377/Watsonville_Police	Watsonville Police
/welcome/agencyarrests/348/West_Covina_Police	West Covina Police
/welcome/agencyarrests/349/West_Hollywood_Sheriff_Substation	West Hollywood SheriffSubstation
/welcome/agencyarrests/285/West_Los_Angeles_CHP	West Los Angeles CHP
/welcome/agencyarrests/353/West_Sacramento_Police	West Sacramento Police
/welcome/agencyarrests/287/West_Valley_CHP	West Valley CHP
/welcome/agencyarrests/297/Westminster_CHP	Westminster CHP
/welcome/agencyarrests/351/Westminster_Police	Westminster Police
/welcome/agencyarrests/588/Whittier_Police	Whittier Police
/welcome/agencyarrests/592/Williams_CHP	Williams CHP
/welcome/agencyarrests/593/Willows_CHP	Willows CHP
/welcome/agencyarrests/289/Winterhaven_CHP	Winterhaven CHP
/welcome/agencyarrests/608/Woodland_CHP	Woodland CHP
/welcome/agencyarrests/587/Woodland_Police	Woodland Police
/welcome/agencyarrests/246/Yolo_County_Sheriff	Yolo County Sheriff
/welcome/agencyarrests/235/Yreka_CHP	Yreka CHP
/welcome/agencyarrests/227/Yuba_County_Sheriff	Yuba County Sheriff
/welcome/agencyarrests/609/Yuba-Sutter_CHP	Yuba-Sutter CHP
/welcome/agencyarrests/3/Alameda_Police	Alameda Police
/welcome/agencyarrests/253/Alameda_County_Sheriff	Alameda County Sheriff
/welcome/agencyarrests/5/Alhambra_Police	Alhambra Police
/welcome/agencyarrests/254/Alpine_County_Sheriff	Alpine County Sheriff
/welcome/agencyarrests/286/Altadena_CHP	Altadena CHP
/welcome/agencyarrests/328/Altadena_Sheriff_Substation	Altadena Sheriff Substation
/welcome/agencyarrests/595/Alturas_CHP	Alturas CHP
/welcome/agencyarrests/610/Amador_CHP	AmadorCHP
/welcome/agencyarrests/255/Amador_County_Sheriff	Amador County Sheriff
/welcome/agencyarrests/249/American_Canyon_Police	American Canyon Police
/welcome/agencyarrests/8/Anaheim_Police	Anaheim Police
/welcome/agencyarrests/414/Antelope_Valley_CHP	Antelope Valley CHP
/welcome/agencyarrests/11/Antioch_Police	Antioch Police
/welcome/agencyarrests/13/Arcadia_Police	Arcadia Police
/welcome/agencyarrests/259/Arrowhead_CHP	Arrowhead CHP
/welcome/agencyarrests/15/Arroyo_Grande_Police	Arroyo Grande Police
/welcome/agencyarrests/18/Atascadero_Police	Atascadero Police
/welcome/agencyarrests/598/Auburn_CHP	Auburn CHP
/welcome/agencyarrests/22/Avalon_Sheriff_Substation	Avalon Sheriff Substation
/welcome/agencyarrests/23/Azusa_Police	Azusa Police
/welcome/agencyarrests/124/Bakersfield_CHP	Bakersfield CHP
/welcome/agencyarrests/24/Bakersfield_Police	Bakersfield Police
/welcome/agencyarrests/485/Baldwin_Park_CHP	Baldwin Park CHP
/welcome/agencyarrests/25/Baldwin_Park_Police	Baldwin Park Police
/welcome/agencyarrests/676/Banning_Police	Banning Police
/welcome/agencyarrests/211/Barstow_CHP	Barstow CHP
/welcome/agencyarrests/758/BART_Police	BART Police
/welcome/agencyarrests/677/Beaumont_Police	Beaumont Police
/welcome/agencyarrests/30/Bell_Police	Bell Police
/welcome/agencyarrests/32/Bell_Gardens_Police	Bell Gardens Police
/welcome/agencyarrests/35/Benicia_Police	Benicia Police
/welcome/agencyarrests/36/Berkeley_-_UC_Police	Berkeley - UC Police
/welcome/agencyarrests/2130/Berkeley_PD_Police	Berkeley PD Police
/welcome/agencyarrests/82/Beverly_Hills_Police	Beverly Hills Police
/welcome/agencyarrests/313/Bishop_CHP	Bishop CHP
/welcome/agencyarrests/296/Blythe_CHP	Blythe CHP
/welcome/agencyarrests/561/Brea_Police	Brea Police
/welcome/agencyarrests/312/Bridgeport_CHP	Bridgeport CHP
/welcome/agencyarrests/309/Buellton_CHP	Buellton CHP
/welcome/agencyarrests/40/Buena_Park_Police	Buena Park Police
/welcome/agencyarrests/41/Burbank_Police	Burbank Police
/welcome/agencyarrests/256/Butte_County_Sheriff	Butte County Sheriff
/welcome/agencyarrests/564/Buttonwillow_CHP	Buttonwillow CHP
/welcome/agencyarrests/2121/CA_Dept._Of_Alcoholic_Beverage_Control	CA Dept. Of Alcoholic Beverage Control 
/welcome/agencyarrests/2067/Cal_State_Chico_Police	Cal State Chico Police
/welcome/agencyarrests/611/Calaveras_County_Sheriff	Calaveras County Sheriff
/welcome/agencyarrests/48/Calistoga_Police	Calistoga Police
/welcome/agencyarrests/49/Campbell_Police	Campbell Police
/welcome/agencyarrests/2039/Campus_Parks_Sheriff_Substation	Campus Parks Sheriff Substation
/welcome/agencyarrests/168/Capistrano_CHP	Capistrano CHP
/welcome/agencyarrests/51/Capitola_Police	Capitola Police
/welcome/agencyarrests/52/Carlsbad_Police	Carlsbad Police
/welcome/agencyarrests/53/Carmel_Police	Carmel Police
/welcome/agencyarrests/55/Carson_Sheriff_Substation	Carson Sheriff Substation
/welcome/agencyarrests/678/Cathedral_City_Police	Cathedral City Police
/welcome/agencyarrests/484/Central_Los_Angeles_CHP	Central Los Angeles CHP
/welcome/agencyarrests/272/Century_Sheriff_Substation	Century Sheriff Substation
/welcome/agencyarrests/367/Cerritos_Sheriff_Substation	Cerritos Sheriff Substation
/welcome/agencyarrests/602/Chico_CHP	Chico CHP
/welcome/agencyarrests/59/Chico_Police	Chico Police
/welcome/agencyarrests/61/Chino_Police	Chino Police
/welcome/agencyarrests/62/Chowchilla_Police	Chowchilla Police
/welcome/agencyarrests/2136/chp_state_capitol_division_CHP	chp state capitol division CHP
/welcome/agencyarrests/63/Chula_Vista_Police	Chula Vista Police
/welcome/agencyarrests/671/Citrus_Heights_Police	Citrus Heights Police
/welcome/agencyarrests/64/Claremont_Police	Claremont Police
/welcome/agencyarrests/107/Clayton_Police	Clayton Police
/welcome/agencyarrests/591/Clear_Lake_CHP	Clear Lake CHP
/welcome/agencyarrests/2112/Cloverdale_Police	Cloverdale Police
/welcome/agencyarrests/67/Clovis_Police	Clovis Police
/welcome/agencyarrests/483/Coalinga_CHP	Coalinga CHP
/welcome/agencyarrests/71/Colma_Police	Colma Police
/welcome/agencyarrests/72/Colton_Police	Colton Police
/welcome/agencyarrests/612/Colusa_County_Sheriff	Colusa County Sheriff
/welcome/agencyarrests/74/Compton_Sheriff_Substation	Compton Sheriff Substation
/welcome/agencyarrests/75/Concord_Police	Concord Police
/welcome/agencyarrests/101/Contra_Costa_CHP	Contra Costa CHP
/welcome/agencyarrests/613/Contra_Costa_County_Sheriff	Contra Costa County Sheriff
/welcome/agencyarrests/78/Corona_Police	Corona Police
/welcome/agencyarrests/79/Coronado_Police	Coronado Police
/welcome/agencyarrests/81/Costa_Mesa_Police	Costa Mesa Police
/welcome/agencyarrests/91/Cotati_Police	Cotati Police
/welcome/agencyarrests/443/Covina_Police	Covina Police
/welcome/agencyarrests/229/Crescent_City_CHP	Crescent City CHP
/welcome/agencyarrests/271/Cresenta_Valley_Sheriff_Substation	Cresenta Valley Sheriff Substation
/welcome/agencyarrests/330/Culver_City_Police	Culver City Police
/welcome/agencyarrests/556/Cypress_Police	Cypress Police
/welcome/agencyarrests/557/Daly_City_Police	Daly City Police
/welcome/agencyarrests/136/Davis_Police	Davis Police
/welcome/agencyarrests/2102/Del_Norte_County_Sheriff	Del Norte County Sheriff
/welcome/agencyarrests/137/Delano_Police	Delano Police
/welcome/agencyarrests/761/Desert_Hot_Springs_Police	Desert Hot Springs Police
/welcome/agencyarrests/334/Dinuba_Police	Dinuba Police
/welcome/agencyarrests/335/Dixon_Police	Dixon Police
/welcome/agencyarrests/126/Downey_Police	Downey Police
/welcome/agencyarrests/122/Dublin_CHP	Dublin CHP
/welcome/agencyarrests/110/Dublin_Police	Dublin Police
/welcome/agencyarrests/487/East_Los_Angeles_CHP	East Los Angeles CHP
/welcome/agencyarrests/445/East_Los_Angeles_Sheriff_Substation	East Los Angeles Sheriff Substation
/welcome/agencyarrests/112/East_Palo_Alto_Police	East Palo Alto Police
/welcome/agencyarrests/299/El_Cajon_CHP	El Cajon CHP
/welcome/agencyarrests/113/El_Cajon_Police	El Cajon Police
/welcome/agencyarrests/290/El_Centro_CHP	El Centro CHP
/welcome/agencyarrests/673/El_Cerrito_Police	El Cerrito Police
/welcome/agencyarrests/615/El_Dorado_County_Sheriff	El Dorado County Sheriff
/welcome/agencyarrests/115/El_Monte_Police	El Monte Police
/welcome/agencyarrests/116/El_Segundo_Police	El Segundo Police
/welcome/agencyarrests/117/Emeryville_Police	Emeryville Police
/welcome/agencyarrests/491/Escondido_Police	Escondido Police
/welcome/agencyarrests/496/Fairfield_Police	Fairfield Police
/welcome/agencyarrests/502/Folsom_Police	Folsom Police
/welcome/agencyarrests/503/Fontana_Police	Fontana Police
/welcome/agencyarrests/565/Fort_Tejon_CHP	Fort Tejon CHP
/welcome/agencyarrests/508/Fountain_Valley_Police	Fountain Valley Police
/welcome/agencyarrests/2030/Fremont_Police	Fremont Police
/welcome/agencyarrests/566/Fresno_CHP	Fresno CHP
/welcome/agencyarrests/512/Fresno_Police	Fresno Police
/welcome/agencyarrests/616/Fresno_County_Sheriff	Fresno County Sheriff
/welcome/agencyarrests/513/Fullerton_Police	Fullerton Police
/welcome/agencyarrests/514/Galt_Police	Galt Police
/welcome/agencyarrests/231/Garberville_CHP	Garberville CHP
/welcome/agencyarrests/516/Garden_Grove_Police	Garden Grove Police
/welcome/agencyarrests/515/Gardena_Police	Gardena Police
/welcome/agencyarrests/517/Gilroy_Police	Gilroy Police
/welcome/agencyarrests/560/Glendale_Police	Glendale Police
/welcome/agencyarrests/518/Glendora_Police	Glendora Police
/welcome/agencyarrests/617/Glenn_County_Sheriff	Glenn County Sheriff
/welcome/agencyarrests/662/Gold_Run_CHP	Gold Run CHP
/welcome/agencyarrests/600/Grass_Valley_CHP	Grass Valley CHP
/welcome/agencyarrests/522/Grass_Valley_Police	Grass Valley Police
/welcome/agencyarrests/337/Gridley_Police	Gridley Police
/welcome/agencyarrests/338/Grover_Beach_Police	Grover Beach Police
/welcome/agencyarrests/567/Hanford_CHP	Hanford CHP
/welcome/agencyarrests/141/Hawthorne_Police	Hawthorne Police
/welcome/agencyarrests/106/Hayward_CHP	Hayward CHP
/welcome/agencyarrests/142/Hayward_Police	Hayward Police
/welcome/agencyarrests/143/Healdsburg_Police	Healdsburg Police
/welcome/agencyarrests/144/Hemet_Police	Hemet Police
/welcome/agencyarrests/155/Hermosa_Beach_Police	Hermosa Beach Police
/welcome/agencyarrests/170/Hollister-Gilroy_CHP	Hollister-Gilroy CHP
/welcome/agencyarrests/230/Humboldt_CHP	Humboldt CHP
/welcome/agencyarrests/618/Humboldt_County_Sheriff	Humboldt County Sheriff
/welcome/agencyarrests/162/Huntington_Beach_Police	Huntington Beach Police
/welcome/agencyarrests/341/Huntington_Park_Police	Huntington Park Police
/welcome/agencyarrests/2095/Imperial_County_Sheriff	Imperial County Sheriff
/welcome/agencyarrests/291/Indio_CHP	Indio CHP
/welcome/agencyarrests/679/Indio_Police	Indio Police
/welcome/agencyarrests/128/Industry_Sheriff_Substation	Industry Sheriff Substation
/welcome/agencyarrests/129/Inglewood_Police	Inglewood Police
/welcome/agencyarrests/239/Inyo_County_Sheriff	Inyo County Sheriff
/welcome/agencyarrests/131/Irvine_Police	Irvine Police
/welcome/agencyarrests/132/Irwindale_Police	Irwindale Police
/welcome/agencyarrests/620/Kern_County_Sheriff	Kern County Sheriff
/welcome/agencyarrests/305/King_City_CHP	King City CHP
/welcome/agencyarrests/621/Kings_County_Sheriff	Kings County Sheriff
/welcome/agencyarrests/398/Kingsburg_Police	Kingsburg Police
/welcome/agencyarrests/402/La_Habra_Police	La Habra Police
/welcome/agencyarrests/408/La_Mesa_Police	La Mesa Police
/welcome/agencyarrests/149/La_Verne_Police	La Verne Police
/welcome/agencyarrests/622/Lake_County_Sheriff	Lake County Sheriff
/welcome/agencyarrests/58/Lakewood_Sheriff_Substation	Lakewood Sheriff Substation
/welcome/agencyarrests/147/Lancaster_Sheriff_Substation	Lancaster Sheriff Substation
/welcome/agencyarrests/623/Lassen_County_Sheriff	Lassen County Sheriff
/welcome/agencyarrests/150/Lennox_Sheriff_Substation	Lennox Sheriff Substation
/welcome/agencyarrests/198/Livermore_Police	Livermore Police
/welcome/agencyarrests/202/Lomita_Sheriff_Substation	Lomita Sheriff Substation
/welcome/agencyarrests/203/Lompoc_Police	Lompoc Police
/welcome/agencyarrests/204/Long_Beach_Police	Long Beach Police
/welcome/agencyarrests/207/Los_Altos_Police	Los Altos Police
/welcome/agencyarrests/460/Los_Angeles_Police	Los Angeles Police
/welcome/agencyarrests/467/Los_Angeles_County_Sheriff	Los Angeles County Sheriff
/welcome/agencyarrests/314/Los_Banos_CHP	Los Banos CHP
/welcome/agencyarrests/462/Los_Gatos_-_Monte_Sereno_Police	Los Gatos - Monte Sereno Police
/welcome/agencyarrests/568/Madera_CHP	Madera CHP	 
/welcome/agencyarrests/466/Madera_Police	Madera Police
/welcome/agencyarrests/468/Madera_County_Sheriff	Madera County Sheriff
/welcome/agencyarrests/464/Malibu_-_Lost_Hills_Sheriff_Substation	Malibu - Lost Hills Sheriff Substation
/welcome/agencyarrests/346/Manhattan_Beach_Police	Manhattan Beach Police
/welcome/agencyarrests/108/Marin_CHP	Marin CHP
/welcome/agencyarrests/469/Marin_County_Sheriff	Marin County Sheriff
/welcome/agencyarrests/324/Marina_Police	Marina Police
/welcome/agencyarrests/270/Marina_Del_Rey_Sheriff_Substation	Marina Del Rey Sheriff Substation
/welcome/agencyarrests/569/Mariposa_CHP	Mariposa CHP
/welcome/agencyarrests/470/Mariposa_County_Sheriff	Mariposa County Sheriff
/welcome/agencyarrests/325/Martinez_Police	Martinez Police
/welcome/agencyarrests/471/Mendocino_County_Sheriff	Mendocino County Sheriff
/welcome/agencyarrests/357/Menlo_Park_Police	Menlo Park Police
/welcome/agencyarrests/570/Merced_CHP	Merced CHP	 
/welcome/agencyarrests/358/Merced_Police	Merced Police	 
/welcome/agencyarrests/216/Merced_County_Sheriff	Merced County Sheriff
/welcome/agencyarrests/361/Milpitas_Police	Milpitas Police
/welcome/agencyarrests/315/Modesto_CHP	Modesto CHP
/welcome/agencyarrests/362/Modesto_Police	Modesto Police
/welcome/agencyarrests/217/Modoc_County_Sheriff	Modoc County Sheriff
/welcome/agencyarrests/209/Mojave_CHP	Mojave CHP
/welcome/agencyarrests/2041/Mono_County_Sheriff	Mono County Sheriff
/welcome/agencyarrests/364/Monrovia_Police	Monrovia Police
/welcome/agencyarrests/366/Montclair_Police	Montclair Police
/welcome/agencyarrests/431/Montebello_Police	Montebello Police
/welcome/agencyarrests/488/Monterey_CHP	Monterey CHP
/welcome/agencyarrests/665/Monterey_Police	Monterey Police
/welcome/agencyarrests/237/Monterey_County_Sheriff	Monterey County Sheriff
/welcome/agencyarrests/432/Monterey_Park_Police	Monterey Park Police
/welcome/agencyarrests/656/Moorpark_CHP	Moorpark CHP
/welcome/agencyarrests/434/Morgan_Hill_Police	Morgan Hill Police
/welcome/agencyarrests/260/Morongo_Basin_CHP	Morongo Basin CHP
/welcome/agencyarrests/435/Morro_Bay_Police	Morro Bay Police
/welcome/agencyarrests/589/Mount_Shasta_CHP	Mount Shasta CHP
/welcome/agencyarrests/436/Mountain_View_Police	Mountain View Police
/welcome/agencyarrests/681/Murrieta_Police	Murrieta Police
/welcome/agencyarrests/102/Napa_CHP	Napa CHP
/welcome/agencyarrests/2118/Napa_Police	Napa Police
/welcome/agencyarrests/479/Napa_County_Sheriff	Napa County Sheriff
/welcome/agencyarrests/439/National_City_Police	National City Police
/welcome/agencyarrests/210/Needles_CHP	Needles CHP
/welcome/agencyarrests/441/Nevada_City_Police	Nevada City Police
/welcome/agencyarrests/480/Nevada_County_Sheriff	Nevada County Sheriff
/welcome/agencyarrests/442/Newark_Police	Newark Police
/welcome/agencyarrests/459/Newhall_CHP	Newhall CHP
/welcome/agencyarrests/274/Newport_Beach_Police	Newport Beach Police
/welcome/agencyarrests/597/North_Sacramento_CHP	North Sacramento CHP
/welcome/agencyarrests/389/Norwalk_Sheriff_Substation	Norwalk Sheriff Substation
/welcome/agencyarrests/276/Novato_Police	Novato Police
/welcome/agencyarrests/663/Oakhurst_CHP	Oakhurst CHP
/welcome/agencyarrests/121/Oakland_CHP	Oakland CHP
/welcome/agencyarrests/278/Oakland_Police	Oakland Police
/welcome/agencyarrests/293/Oceanside_CHP	Oceanside CHP
/welcome/agencyarrests/279/Oceanside_Police	Oceanside Police
/welcome/agencyarrests/379/Ontario_Police	Ontario Police
/welcome/agencyarrests/446/Orange_Police	Orange Police
/welcome/agencyarrests/558/Orange_County_Sheriff	Orange County Sheriff
/welcome/agencyarrests/601/Oroville_CHP	Oroville CHP
/welcome/agencyarrests/451/Oxnard_Police	Oxnard Police
/welcome/agencyarrests/529/Palm_Springs_Police	Palm Springs Police
/welcome/agencyarrests/527/Palmdale_Sheriff_Substation	Palmdale Sheriff Substation
/welcome/agencyarrests/281/Palo_Alto_Police	Palo Alto Police
/welcome/agencyarrests/282/Palos_Verdes_Estates_Police	Palos Verdes Estates Police
/welcome/agencyarrests/284/Parlier_Police	Parlier Police
/welcome/agencyarrests/153/Pasadena_Police	Pasadena Police
/welcome/agencyarrests/409/Paso_Robles_Police	Paso Robles Police
/welcome/agencyarrests/412/Petaluma_Police	Petaluma Police
/welcome/agencyarrests/413/Pico_Rivera_Sheriff_Substation	Pico Rivera Sheriff Substation
/welcome/agencyarrests/453/Piedmont_Police	Piedmont Police
/welcome/agencyarrests/2091/Pinole_Police	Pinole Police
/welcome/agencyarrests/457/Pismo_Beach_Police	Pismo Beach Police
/welcome/agencyarrests/458/Pittsburg_Police	Pittsburg Police
/welcome/agencyarrests/380/Placentia_Police	Placentia Police
/welcome/agencyarrests/151/Placer_County_Sheriff	Placer County Sheriff
/welcome/agencyarrests/603/Placerville_CHP	Placerville CHP
/welcome/agencyarrests/382/Pleasant_Hill_Police	Pleasant Hill Police
/welcome/agencyarrests/383/Pleasanton_Police	Pleasanton Police
/welcome/agencyarrests/2063/Plumas_County_Sheriff	Plumas County Sheriff
/welcome/agencyarrests/386/Pomona_Police	Pomona Police
/welcome/agencyarrests/482/Porterville_CHP	Porterville CHP
/welcome/agencyarrests/387/Porterville_Police	Porterville Police
/welcome/agencyarrests/594/Quincy_CHP	Quincy CHP
/welcome/agencyarrests/311/Rancho_Cucamonga_CHP	Rancho Cucamonga CHP
/welcome/agencyarrests/232/Red_Bluff_CHP	Red Bluff CHP
/welcome/agencyarrests/233/Redding_CHP	Redding CHP
/welcome/agencyarrests/579/Redding_Police	Redding Police
/welcome/agencyarrests/580/Redlands_Police	Redlands Police
/welcome/agencyarrests/581/Redondo_Beach_Police	Redondo Beach Police
/welcome/agencyarrests/103/Redwood_City_CHP	Redwood City CHP
/welcome/agencyarrests/582/Redwood_City_Police	Redwood City Police
/welcome/agencyarrests/583/Reedley_Police	Reedley Police
/welcome/agencyarrests/584/Rialto_Police	Rialto Police
/welcome/agencyarrests/585/Richmond_Police	Richmond Police
/welcome/agencyarrests/212/Riverside_CHP	Riverside CHP
/welcome/agencyarrests/317/Riverside_Police	Riverside Police
/welcome/agencyarrests/26/Riverside_SD_-_Banning_Smith_Correctional_Facility_Sheriff	Riverside SD - Banning Smith Correctional Facility Sheriff
/welcome/agencyarrests/87/Riverside_County_-_Blythe_Jail_-_Sheriff	Riverside County - Blythe Jail - Sheriff	 
/welcome/agencyarrests/327/Riverside_SD_-_John_Benoit_Detention_Center_Sheriff	Riverside SD - John Benoit Detention Center Sheriff
/welcome/agencyarrests/2035/Riverside_County_-_Robert_Presley_DC_-_Sheriff	 Riverside County - Robert Presley DC - Sheriff	 
/welcome/agencyarrests/571/Riverside_County_-_Southwest_DC_-_Sheriff	Riverside County - Southwest DC - Sheriff	 
/welcome/agencyarrests/172/Rohnert_Park_Police	Rohnert Park Police
/welcome/agencyarrests/176/Roseville_Police	Roseville Police
/welcome/agencyarrests/550/Sacramento_County_Sheriff	Sacramento County Sheriff
/welcome/agencyarrests/605/San_Andreas_CHP	San Andreas CHP
/welcome/agencyarrests/417/San_Benito_County_Sheriff	San Benito County Sheriff
/welcome/agencyarrests/215/San_Bernardino_CHP	San Bernardino CHP
/welcome/agencyarrests/418/San_Bernardino_County_Sheriff	San Bernardino County Sheriff
/welcome/agencyarrests/292/San_Diego_CHP	San Diego CHP
/welcome/agencyarrests/302/San_Diego_Police	San Diego Police
/welcome/agencyarrests/419/San_Diego_County_Sheriff	San Diego County Sheriff
/welcome/agencyarrests/303/San_Dimas_Sheriff_Substation	San Dimas Sheriff Substation
/welcome/agencyarrests/104/San_Francisco_CHP	San Francisco CHP
/welcome/agencyarrests/318/San_Francisco_Police	San Francisco Police
/welcome/agencyarrests/2056/San_Francisco_County_Sheriff	San Francisco County Sheriff
/welcome/agencyarrests/319/San_Gabriel_Police	San Gabriel Police
/welcome/agencyarrests/295/San_Gorgonio_Pass_CHP	San Gorgonio Pass CHP
/welcome/agencyarrests/257/San_Joaquin_County_Sheriff	San Joaquin County Sheriff
/welcome/agencyarrests/105/San_Jose_CHP	San Jose CHP
/welcome/agencyarrests/531/San_Jose_Police	San Jose Police
/welcome/agencyarrests/208/San_Leandro_Police	San Leandro Police
/welcome/agencyarrests/307/San_Luis_Obispo_CHP	San Luis Obispo CHP
/welcome/agencyarrests/214/San_Luis_Obispo_Police	San Luis Obispo Police
/welcome/agencyarrests/258/San_Luis_Obispo_County_Sheriff	San Luis Obispo County Sheriff
/welcome/agencyarrests/422/San_Marino_Police	San Marino Police
/welcome/agencyarrests/423/San_Mateo_Police	San Mateo Police
/welcome/agencyarrests/472/San_Mateo_County_Sheriff	San Mateo County Sheriff
/welcome/agencyarrests/424/San_Pablo_Police	San Pablo Police
/welcome/agencyarrests/425/San_Rafael_Police	San Rafael Police
/welcome/agencyarrests/426/San_Ramon_Police	San Ramon Police
/welcome/agencyarrests/320/Sanger_Police	Sanger Police
/welcome/agencyarrests/298/Santa_Ana_CHP	Santa Ana CHP
/welcome/agencyarrests/427/Santa_Ana_Police	Santa Ana Police
/welcome/agencyarrests/310/Santa_Barbara_CHP	Santa Barbara CHP
/welcome/agencyarrests/428/Santa_Barbara_Police	Santa Barbara Police
/welcome/agencyarrests/473/Santa_Barbara_County_Sheriff	Santa Barbara County Sheriff
/welcome/agencyarrests/265/Santa_Clara_Police	Santa Clara Police
/welcome/agencyarrests/474/Santa_Clara_County_Sheriff	Santa Clara County Sheriff
/welcome/agencyarrests/429/Santa_Clarita_Valley_Sheriff_Substation	Santa Clarita Valley Sheriff Substation
/welcome/agencyarrests/169/Santa_Cruz_CHP	Santa Cruz CHP
/welcome/agencyarrests/388/Santa_Cruz_Police	Santa Cruz Police
/welcome/agencyarrests/475/Santa_Cruz_County_Sheriff	Santa Cruz County Sheriff
/welcome/agencyarrests/415/Santa_Fe_Springs_CHP	Santa Fe Springs CHP
/welcome/agencyarrests/2052/Santa_Fe_Springs_Police	Santa Fe Springs Police
/welcome/agencyarrests/308/Santa_Maria_CHP	Santa Maria CHP
/welcome/agencyarrests/391/Santa_Monica_Police	Santa Monica Police
/welcome/agencyarrests/392/Santa_Paula_Police	Santa Paula Police
/welcome/agencyarrests/118/Santa_Rosa_CHP	Santa Rosa CHP
/welcome/agencyarrests/393/Santa_Rosa_Police	Santa Rosa Police
/welcome/agencyarrests/534/Seaside_Police	Seaside Police
/welcome/agencyarrests/535/Sebastopol_Police	Sebastopol Police
/welcome/agencyarrests/536/Selma_Police	Selma Police
/welcome/agencyarrests/537/Shafter_Police	Shafter Police
/welcome/agencyarrests/476/Shasta_County_Sheriff	Shasta County Sheriff
/welcome/agencyarrests/541/Simi_Valley_Police	Simi Valley Police
/welcome/agencyarrests/2107/Siskiyou_County_Sheriff	Siskiyou County Sheriff
/welcome/agencyarrests/119/Solano_CHP	Solano CHP
/welcome/agencyarrests/619/Solano_County_Sheriff	Solano County Sheriff
/welcome/agencyarrests/218/Sonoma_County_Sheriff	Sonoma County Sheriff
/welcome/agencyarrests/563/Sonora_CHP	Sonora CHP
/welcome/agencyarrests/547/South_Gate_Police	South Gate Police
/welcome/agencyarrests/604/South_Lake_Tahoe_CHP	South Lake Tahoe CHP
/welcome/agencyarrests/486/South_Los_Angeles_CHP	South Los Angeles CHP
/welcome/agencyarrests/660/South_Sacramento_CHP	South Sacramento CHP
/welcome/agencyarrests/186/South_San_Francisco_Police	South San Francisco Police
/welcome/agencyarrests/2115/St_Helena_Police	St Helena Police
/welcome/agencyarrests/219/Stanislaus_County_Sheriff	Stanislaus County Sheriff
/welcome/agencyarrests/606/Stockton_CHP	Stockton CHP
/welcome/agencyarrests/189/Sunnyvale_Police	Sunnyvale Police
/welcome/agencyarrests/234/Susanville_CHP	Susanville CHP
/welcome/agencyarrests/220/Sutter_County_Sheriff	Sutter County Sheriff
/welcome/agencyarrests/221/Tehama_County_Sheriff	Tehama County Sheriff
/welcome/agencyarrests/167/Temecula_CHP	Temecula CHP
/welcome/agencyarrests/551/Temple_Sheriff_Substation	Temple Sheriff Substation
/welcome/agencyarrests/306/Templeton_CHP	Templeton CHP
/welcome/agencyarrests/163/Torrance_Police	Torrance Police
/welcome/agencyarrests/607/Tracy_CHP	Tracy CHP
/welcome/agencyarrests/222/Trinity_County_Sheriff	Trinity County Sheriff
/welcome/agencyarrests/596/Trinity_River_CHP	Trinity River CHP
/welcome/agencyarrests/599/Truckee_CHP	Truckee CHP
/welcome/agencyarrests/120/Truckee_Police	Truckee Police
/welcome/agencyarrests/166/Tulare_Police	Tulare Police
/welcome/agencyarrests/223/Tulare_County_Sheriff	Tulare County Sheriff
/welcome/agencyarrests/224/Tuolumne_County_Sheriff	Tuolumne County Sheriff
/welcome/agencyarrests/93/Tustin_Police	Tustin Police
/welcome/agencyarrests/763/UC_Irvine_Police	UC Irvine Police
/welcome/agencyarrests/2025/UC_San_Diego_Police	UC San Diego Police
/welcome/agencyarrests/2124/UCLA_Police	UCLA Police
/welcome/agencyarrests/590/Ukiah_CHP	Ukiah CHP
/welcome/agencyarrests/98/Vacaville_Police	Vacaville Police
/welcome/agencyarrests/99/Vallejo_Police	Vallejo Police
/welcome/agencyarrests/228/Ventura_CHP	Ventura CHP
/welcome/agencyarrests/2031/Ventura_Police	Ventura Police
/welcome/agencyarrests/225/Ventura_County_Sheriff	Ventura County Sheriff
/welcome/agencyarrests/100/Vernon_Police	Vernon Police
/welcome/agencyarrests/213/Victorville_CHP	Victorville CHP
/welcome/agencyarrests/481/Visalia_CHP	Visalia CHP
/welcome/agencyarrests/370/Visalia_Police	Visalia Police
/welcome/agencyarrests/373/Walnut_-_Diamond_Bar_Sheriff_Substation	Walnut - Diamond Bar Sheriff Substation
/welcome/agencyarrests/374/Walnut_Creek_Police	Walnut Creek Police
/welcome/agencyarrests/377/Watsonville_Police	Watsonville Police
/welcome/agencyarrests/348/West_Covina_Police	West Covina Police
/welcome/agencyarrests/349/West_Hollywood_Sheriff_Substation	West Hollywood Sheriff Substation
/welcome/agencyarrests/285/West_Los_Angeles_CHP	West Los Angeles CHP
/welcome/agencyarrests/353/West_Sacramento_Police	West Sacramento Police
/welcome/agencyarrests/287/West_Valley_CHP	West Valley CHP
/welcome/agencyarrests/297/Westminster_CHP	Westminster CHP
/welcome/agencyarrests/351/Westminster_Police	Westminster Police
/welcome/agencyarrests/588/Whittier_Police	Whittier Police
/welcome/agencyarrests/592/Williams_CHP	Williams CHP
/welcome/agencyarrests/593/Willows_CHP	Willows CHP
/welcome/agencyarrests/289/Winterhaven_CHP	Winterhaven CHP
/welcome/agencyarrests/608/Woodland_CHP	Woodland CHP
/welcome/agencyarrests/587/Woodland_Police	Woodland Police
/welcome/agencyarrests/246/Yolo_County_Sheriff	Yolo County Sheriff
/welcome/agencyarrests/235/Yreka_CHP	Yreka CHP
/welcome/agencyarrests/227/Yuba_County_Sheriff	Yuba County Sheriff
/welcome/agencyarrests/609/Yuba-Sutter_CHP	Yuba-Sutter CHP